####....####
#..#....#..#
#..#....#..#
####....####
############
#..##..##..#
#..##..##..#
############
####....####
#..#....#..#
####....####