##........##
###......###
.###....###.
..###..###..
...######...
....####....
....####....
....####....
..###..###..
.###....###.
###......###