.######.
########
##....##
##....##
##....##
########
.######.