.....##.....
....####....
...######...
..########..
.##########.
############
....####....
....####....
....####....
....####....
....####....