####....####
#..#....#..#
#..#....#..#
####....####
....####....
....#..#....
....####....
####....####
#..#....#..#
#..#....#..#
####....####