##........##
###......###
####....####
..###..###..
...######...
....####....
....####....
...######...
..###..###..
.###....###.
###......###