.....##.....
....####....
...######...
..########..
.##########.
############
.##########.
..########..
...######...
....####....
.....##.....