.......#####
......######
.....#######
....########
...########.
..########..
.########...
########....
#######.....
######......
#####.......