############
.##########.
..########..
...######...
....####....
....####....
....####....
.....##.....
.....##.....
.....##.....
.....##.....