..##....##..
.####..####.
############
.####..####.
..##....##..
............
..##....##..
.####..####.
############
.####..####.
..##....##..