.....##.....
....####....
...######...
..##....##..
.###....###.
####....####
.###....###.
..##....##..
...######...
....####....
.....##.....