..########..
.##########.
##........##
##........##
.##########.
..########..
..########..
.##########.
##........##
##........##
.##########.