##...##...##
##...##...##
..#..##..#..
...#.##.#...
....####....
############
....####....
...#.##.#...
..#..##..#..
##...##...##
##...##...##