####....####
###......###
##........##
#....##....#
....####....
...######...
....####....
#....##....#
##........##
###......###
####....####