#####..#####
##..####..##
..#..##..#..
...######...
#..######..#
############
#..######..#
...######...
..#..##..#..
##..####..##
#####..#####