....####....
...######...
..########..
.###....###.
###......###
###......###
###......###
.###....###.
..########..
...######...
....####....