.....##.....
....####....
...######...
..##.##.##..
......#..##.
############
.##..##..##.
..##.##.##..
...######...
....####....
.....##.....