XXXXXXXXXXXXXXXXXXXXXXXXXXXXXXXXXXXXXXXXXXXXXXXXXX
X                                                X
X XXXXXX XXXXX XXXXXXXX XXXXXXXX XX XXXXX XXXXXX X
X X      XXXXX XXXXXXXX XXXXXXXX XX XXXXX      X X
X X XXXX XXXXX XXXXXXXX XXXXXXXX XX XXXXX XXXX X X
X   XXXX XXXXX XXXXXXXX XXXXXXXX XX XXXXX XXXX   X
XXXXXXXX XX       X     XX    XX XX XX    XXXXXXXX
X        XX XX XX X XX XXX XX XX XX XX XX        X
X XXXXXX XX XX XX X XX XXX XX XX XX XX XX XXXXXX X
X XXXXXX XX XX XX X    XXX XX XX XX XX XX XXXXXX X
X XXXXXX XX XX XX X XXXXXX XX XX XX XX XX XXXXXX X
X XXXXXX    XX XX   XXXXXX XX             XXXXXX X
X XXXXXX XXXXX XXXX           XXXXXXXXXXX XXXXXX X
X                 XXXXXXXXXXX XXXXXXXXXXX        X
XXXX XXX XXXXXXXX XXXXXXXXXXX XXXXXXXXXXXXXX XXXXX
XXXX XXX XXXXXXXX XXXXXXXXXXX         XXXXXX XXXXX
XXXX XXX XXXXX    XXXXXXXXXXX XXXXXXX XXXXXX XXXXX
XXXX XXX XXXXX XXXXXXXXXXXXXX XXXXXXX           XX
XXXX XXX    XX XX     XX      XXXXXXX XXXXXXXXX XX
XXXX XXX XX XX XX XXX XX XXX XXXXXXXX XXXXXXXXX XX
XXXX XXX XX XX XX XXX XX XXX XXXXXXXX XXXXXXXXX XX
XXXX XXX XX XX XX XXX XX     XXXXX    XXXXXXXXX XX
XXXX XXX XX XX XX XXX XX XXXXXXXXX XX      XXXX XX
XXXX XXX XX XX XX XXX XX XXXXXXXXX XXXXXXX      XX
XX       XX    XX     XX      XXXX XXXXXXX XX XXXX
XX XXX XXXXXXXXXX XXXXXXXXXXX XXXX XXXXXXX XX XXXX
XX XXX XXXX       XXXXXXXXXXX XXXX XXXXXXX XX   XX
XX XXX XXXX XXXXX XXXXXXXXXXX XXXX XXXXXXX XXXX XX
XX XXX XXXX XXXXX XXXXXXXXXXX                   XX
XX                    XXXXXXX XXXXXXXXXXXXXX XXXXX
XX XXXXXXXXX XXXXXXXX         XXXXXXXXXXXXXX XXXXX
XX XXXXXXXXX XXXXXXXX XXXXXXX                XXXXX
XX       XXX XXX      XXXXXXXX XXXXXXXXXXXXX XXXXX
XX XXXXX XXX XXX XXXXXXXXXXXXX XXXXXXXXXXXXX XXXXX
XX XXXXX XXX XXX XXXXXXXXXXXXX XXXXXXXXXXXXX XXXXX
XX    XX XXX XXX      XX       XXXXXXXXX        XX
XX XX XX XXX XXX XXXX XX XXXXX XXXXXXXXX XXXXXX XX
XX XX XX XXX XXX XXXX                    XXXXXX XX
XX XX XX     XXX XXXXXX XXXXXX XXXXX XXX XXXXXX XX
XX XX XX XXXXXXX XXXXXX XXXXXX  XXXX XXX XXXXXX XX
XX XX XX XXXXXXX XXXXXX XXXXXXX XXXX XXX XXXXXX XX
X                                                X
X XX XXXXXXXX XXXXXXXX XXXX XXXXXXXX XXXXXXXX XX X
X XX XXXXXXXX    XXXXX XXXX XXXXX    XXXXXXXX XX X
X          XX XX XXXXX XXXX XXXXX XX XX          X
X XXXXXXXX XX XX XXXXX XXXX XXXXX XX XX XXXXXXXX X
X XX    XX XX XX XX            XX XX XX XX    XX X
X XX XX XX XX XX XX XXXXXXXXXX XX XX XX XX XX XX X
X                                                X
XXXXXXXXXXXXXXXXXXXXXXXXXXXXXXXXXXXXXXXXXXXXXXXXXX